American--Synonyms: American English
Feminine--Synonyms: womanly
Internal--Synonyms: intragroup, home, interior
Ordinary--Synonyms: ordinary bicycle, average
Physical--Synonyms: forcible, strong-arm
Innocent--Synonyms: inexperienced person
Tropical--Synonyms: tropic, tropic
Electric--Synonyms: electric automobile
Pregnant--Synonyms: meaning, significant, fraught
Positive--Synonyms: positive degree, convinced
Opposite--Synonyms: antonym, opposite word
Possible--Synonyms: potential
Accurate--Synonyms: exact, precise
Chemical--Synonyms: chemical substance, chemic
Caroline--Synonyms: Carolean
Canadian--Synonyms: Canadian River
Straight--Synonyms: heterosexual
Separate--Synonyms: offprint, reprint
Standard--Synonyms: criterion, measure
Thankful--Synonyms: grateful
Fearless--Synonyms: unafraid, audacious
Original--Synonyms: master, archetype, pilot
Gracious--Synonyms: benignant, courteous, nice
Filipino--Synonyms: Philippine, Philippine
Constant--Synonyms: constant quantity, invariable
Biblical--Synonyms: scriptural
Friendly--Synonyms: favorable, well-disposed
Delicate--Synonyms: fragile, frail, soft
National--Synonyms: subject, home
Powerful--Synonyms: knock-down, potent
Variable--Synonyms: variable quantity
Graceful--Synonyms: elegant, refined
Military--Synonyms: armed forces, armed services
Relative--Synonyms: relation, congener,
Northern--Synonyms: northerly, northerly
Colorful--Synonyms: colourful, colourful
Breaking--Synonyms: breakage, break
Southern--Synonyms: southerly, southerly
Creative--Synonyms: originative
Selfless--Synonyms: altruistic
Insecure--Synonyms: unsafe, unsafe
Exciting--Synonyms: excite, stimulate
Infinite--Synonyms: space, non-finite
